{
  "levels": [
    {
      "height": 6,
      "lines": [
        "#####",
        "#   #",
        "#.$.#",
        "# $ #",
        "#+$ #",
        "#####"
      ],
      "width": 5
    },
    {
      "height": 6,
      "lines": [
        "#####",
        "#.  #",
        "# $ #",
        "# * #",
        "# $+#",
        "#####"
      ],
      "width": 5
    },
    {
      "height": 6,
      "lines": [
        "######",
        "#.   #",
        "#@$$$#",
        "#$. .#",
        "# .$.#",
        "######"
      ],
      "width": 6
    },
    {
      "height": 6,
      "lines": [
        "######",
        "#    #",
        "#.# .#",
        "# $$ #",
        "#.@$ #",
        "######"
      ],
      "width": 6
    },
    {
      "height": 6,
      "lines": [
        "######",
        "#  . #",
        "#+$* #",
        "#$$  #",
        "#  . #",
        "######"
      ],
      "width": 6
    },
    {
      "height": 6,
      "lines": [
        "######",
        "#   .##",
        "#+* $.#",
        "#$$ # #",
        "#     #",
        "#######"
      ],
      "width": 7
    },
    {
      "height": 6,
      "lines": [
        " ######",
        "##  $+#",
        "#  *$$#",
        "# #  .#",
        "#  .  #",
        "#######"
      ],
      "width": 7
    },
    {
      "height": 6,
      "lines": [
        "#######",
        "# .   #",
        "#  #$@#",
        "# * $*#",
        "#  .  #",
        "#######"
      ],
      "width": 7
    },
    {
      "height": 6,
      "lines": [
        "#######",
        "#  *@ #",
        "#.  # #",
        "#$$*  #",
        "# .   #",
        "#######"
      ],
      "width": 7
    },
    {
      "height": 7,
      "lines": [
        " #####",
        " #   ##",
        "## #$ #",
        "#  .$.#",
        "#   $@#",
        "###. ##",
        "  ####"
      ],
      "width": 7
    },
    {
      "height": 7,
      "lines": [
        "  #####",
        "###.  #",
        "#.$.  #",
        "# @# ##",
        "# $$ #",
        "##   #",
        " #####"
      ],
      "width": 7
    },
    {
      "height": 7,
      "lines": [
        " ######",
        "##   @#",
        "#   $ #",
        "#.##$##",
        "#.  $ #",
        "#.    #",
        "#######"
      ],
      "width": 7
    },
    {
      "height": 7,
      "lines": [
        "#####",
        "#   ###",
        "#@* $ #",
        "##$ #.#",
        "# $  .#",
        "#    .#",
        "#######"
      ],
      "width": 7
    },
    {
      "height": 8,
      "lines": [
        "#####",
        "#   ###",
        "# #@$ #",
        "#. *# #",
        "# $.  #",
        "##  ###",
        " #  #",
        " ####"
      ],
      "width": 7
    },
    {
      "height": 8,
      "lines": [
        "#######",
        "#     #",
        "#*$#$ #",
        "#@$   #",
        "# # $##",
        "#.* $ #",
        "#... .#",
        "#######"
      ],
      "width": 7
    },
    {
      "height": 6,
      "lines": [
        "######",
        "#. $@#",
        "#$ * #",
        "#.$  #",
        "#  . #",
        "######"
      ],
      "width": 6
    },
    {
      "height": 7,
      "lines": [
        "######",
        "# *  #",
        "#  * #",
        "#* $ #",
        "#@$. #",
        "# . ##",
        "#####"
      ],
      "width": 6
    },
    {
      "height": 8,
      "lines": [
        "######",
        "# *  #",
        "#  * #",
        "#$ * #",
        "#@*  #",
        "# * ##",
        "#.  #",
        "#####"
      ],
      "width": 6
    }
  ],
  "maxHeight": 8,
  "maxWidth": 7,
  "name": "Petitesse",
  "numLevels": 18
}